NO ./texture/doom1.png
SO ./texture/doom2.png
WE ./texture/doom3.png
EA ./texture/doom4.png

C 0,255,255
F 160,160,160

11111111111111111111111111111
10010000000000010100000000001
100100010000000100M0000100001
10010001100010000000000100111
10000001000001100001111100001
10111000000000100N00000000001
11111111111111111111111111111