11111111111111
1000000N001101
10010000000001
10000000000001
11111000011111

