  1111111
 100000001
 101101101
 101101101
 1000N0001
 101101101
 101101101
 100000001
  1111111 