 11111111111111111111
1100000000000000000001
1N00000000000000000001
1100000000000000000001
1000000000000000000001
1000000000000000000001
1000000000000000000001
 11111111111111111111